%%%%%%%%%%%%%%
%G           %
%            %
%            %
%            %
%            %
%            %
%           P%
%%%%%%%%%%%%%%
% %%%%%%%%%%%%
%%%%%%%%%%%%%%
