%%%%%%%%%%%%%%%%
%   P  %       %
%G%%%%%%% %%%%G%
%..GG      %   %
%%%%%%%%%%%%%%%%
