%%%%%%%%%%%%%%%%%%%%%%%%%
%       ...........     %
%   P ...............   %
%    ...%%%      %%%..  %
%    ...%o%      %o%..  %
%   ....%%%      %%%..G %
%   ....     %%%    ..  %
%  .....      %      .. %
%  .....%          % .. %
%  .... %%%      %%%    %
% .....   %%%%%%%%      %
% ..... GGGGGGGGGG      %
%%%%%%%%%%%%%%%%%%%%%%%%%
% % % % %%%%%%%%%%%%%%%%%
%%%%%%%%%%%%%%%%%%%%%%%%%
