%%%%%%%%%%%%%%
%           G%
%G %    %%%%%%
%%%%       ..%
%G %   .  %%%%
%         %..%
%%%       %  %
%..         P%
%%%%%%%%%%%%%%
% % % %%%%%%%%
%%%%%%%%%%%%%%
